###############
#-----#-------#
#-----#---#---#
#-----#---#---#
#---------#---#
###############
